Code,Town,Year,2010 Census Units,Gov Assisted,Tenant Rental Assistance, Single Family CHFA/ USDA Mortgages,Deed Restricted Units,Total Assisted Units,Percent Affordable
1,Andover,2016,1317,18,0,22,0,40,3.04
2,Ansonia,2016,8148,347,658,104,9,1118,13.72
3,Ashford,2016,1903,32,2,33,0,67,3.52
4,Avon,2016,7389,244,8,31,0,283,3.83
5,Barkhamsted,2016,1589,0,7,13,0,20,1.26
6,Beacon Falls,2016,2509,0,3,34,0,37,1.47
7,Berlin,2016,8140,556,47,102,10,715,8.78
8,Bethany,2016,2044,0,2,7,1,10,0.49
9,Bethel,2016,7310,152,22,98,69,341,4.66
10,Bethlehem,2016,1575,24,0,4,0,28,1.78
11,Bloomfield,2016,9019,591,93,292,0,976,10.82
12,Bolton,2016,2015,0,2,18,0,20,0.99
13,Bozrah,2016,1059,0,3,30,0,33,3.12
14,Branford,2016,13972,243,63,145,0,451,3.23
15,Bridgeport,2016,57012,6279,4102,900,19,11300,19.82
16,Bridgewater,2016,881,0,0,4,0,4,0.45
17,Bristol,2016,27011,1916,844,931,0,3691,13.66
18,Brookfield,2016,6562,83,22,74,77,256,3.9
19,Brooklyn,2016,3235,231,12,103,0,346,10.7
20,Burlington,2016,3389,42,0,30,0,72,2.12
21,Canaan,2016,779,35,5,15,1,56,7.19
22,Canterbury,2016,2043,76,1,62,0,139,6.8
23,Canton,2016,4339,211,15,46,32,304,7.01
24,Chaplin,2016,988,0,0,33,0,33,3.34
25,Cheshire,2016,10424,259,20,69,17,365,3.5
26,Chester,2016,1923,23,3,14,0,40,2.08
27,Clinton,2016,6065,84,16,34,0,134,2.21
28,Colchester,2016,6182,364,40,120,0,524,8.48
29,Colebrook,2016,722,0,0,7,1,8,1.11
30,Columbia,2016,2308,40,2,56,0,98,4.25
31,Cornwall,2016,1007,28,2,3,0,33,3.28
32,Coventry,2016,5099,108,4,117,20,249,4.88
33,Cromwell,2016,6001,212,7,161,0,380,6.33
34,Danbury,2016,31154,1588,926,468,296,3278,10.52
35,Darien,2016,7074,136,6,1,98,241,3.41
36,Deep River,2016,2096,26,3,20,0,49,2.34
37,Derby,2016,5849,274,316,76,0,666,11.39
38,Durham,2016,2694,36,0,10,0,46,1.71
40,East Granby,2016,2152,72,0,38,0,110,5.11
41,East Haddam,2016,4508,73,3,23,0,99,2.2
42,East Hampton,2016,5485,70,6,75,25,176,3.21
43,East Hartford,2016,21328,1576,859,904,0,3339,15.66
44,East Haven,2016,12533,542,140,266,0,948,7.56
45,East Lyme,2016,8458,396,16,77,19,508,6.01
47,East Windsor,2016,5045,559,34,99,14,706,13.99
39,Eastford,2016,793,0,0,18,0,18,2.27
46,Easton,2016,2715,0,0,1,15,16,0.59
48,Ellington,2016,6665,260,5,97,0,362,5.43
49,Enfield,2016,17558,1340,217,540,7,2104,11.98
50,Essex,2016,3261,36,3,10,0,49,1.5
51,Fairfield,2016,21648,218,108,43,112,481,2.22
52,Farmington,2016,11106,470,108,118,155,851,7.66
53,Franklin,2016,771,27,0,22,0,49,6.36
54,Glastonbury,2016,13656,582,36,107,2,727,5.32
55,Goshen,2016,1664,1,1,5,0,7,0.42
56,Granby,2016,4360,85,1,41,5,132,3.03
57,Greenwich,2016,25631,856,338,11,54,1259,4.91
58,Griswold,2016,5118,148,58,174,0,380,7.42
59,Groton,2016,17978,3587,103,326,10,4026,22.39
60,Guilford,2016,9596,186,7,32,0,225,2.34
61,Haddam,2016,3504,22,0,30,0,52,1.48
62,Hamden,2016,25114,935,635,432,4,2006,7.99
63,Hampton,2016,793,0,1,27,0,28,3.53
64,Hartford,2016,51822,9972,8439,1428,0,19839,38.28
65,Hartland,2016,856,2,0,3,0,5,0.58
66,Harwinton,2016,2282,22,4,29,0,55,2.41
67,Hebron,2016,3567,58,3,33,0,94,2.64
68,Kent,2016,1665,53,5,4,0,62,3.72
69,Killingly,2016,7592,520,112,297,0,929,12.24
70,Killingworth,2016,2598,0,0,18,5,23,0.89
71,Lebanon,2016,3125,26,4,74,0,104,3.33
72,Ledyard,2016,5987,32,8,186,0,226,3.77
73,Lisbon,2016,1730,2,0,49,0,51,2.95
74,Litchfield,2016,3975,140,7,22,19,188,4.73
75,Lyme,2016,1223,0,0,2,8,10,0.82
76,Madison,2016,8049,90,3,8,29,130,1.62
77,Manchester,2016,25996,1850,890,826,34,3600,13.85
78,Mansfield,2016,6017,417,123,99,2,641,10.65
79,Marlborough,2016,2389,24,2,22,0,48,2.01
80,Meriden,2016,25892,2027,1103,936,11,4077,15.75
81,Middlebury,2016,2892,76,4,14,20,114,3.94
82,Middlefield,2016,1863,30,4,11,1,46,2.47
83,Middletown,2016,21223,3019,1035,445,25,4524,21.32
84,Milford,2016,23074,726,220,179,87,1212,5.25
85,Monroe,2016,6918,32,3,33,1,69,1
86,Montville,2016,7407,81,45,223,0,349,4.71
87,Morris,2016,1314,20,3,2,0,25,1.9
88,Naugatuck,2016,13061,493,270,287,0,1050,8.04
89,New Britain,2016,31226,2901,1478,1054,256,5689,18.22
90,New Canaan,2016,7551,163,13,2,23,201,2.66
91,New Fairfield,2016,5593,0,4,47,21,72,1.29
92,New Hartford,2016,2923,12,8,45,15,80,2.74
93,New Haven,2016,54967,9055,5709,1029,639,16432,29.89
95,New London,2016,11840,1713,449,449,106,2717,22.95
96,New Milford,2016,11731,268,23,129,16,436,3.72
94,Newington,2016,13011,530,108,384,36,1058,8.13
97,Newtown,2016,10061,134,6,63,15,218,2.17
98,Norfolk,2016,967,28,3,5,0,36,3.72
99,North Branford,2016,5629,62,14,46,4,126,2.24
100,North Canaan,2016,1587,138,0,8,0,146,9.2
101,North Haven,2016,9491,341,47,79,0,467,4.92
102,North Stonington,2016,2306,0,2,28,4,34,1.47
103,Norwalk,2016,35415,2224,1277,299,701,4501,12.71
104,Norwich,2016,18659,2225,784,484,0,3493,18.72
105,Old Lyme,2016,5021,60,2,8,3,73,1.45
106,Old Saybrook,2016,5602,50,9,13,20,92,1.64
107,Orange,2016,5345,46,6,13,6,71,1.33
108,Oxford,2016,4746,36,5,27,0,68,1.43
109,Plainfield,2016,6229,377,177,283,0,837,13.44
110,Plainville,2016,8063,205,48,249,22,524,6.5
111,Plymouth,2016,5109,178,11,187,0,376,7.36
112,Pomfret,2016,1684,32,2,14,0,48,2.85
113,Portland,2016,4077,185,84,66,0,335,8.22
114,Preston,2016,2019,40,8,37,0,85,4.21
115,Prospect,2016,3474,0,6,39,0,45,1.3
116,Putnam,2016,4299,383,67,112,0,562,13.07
117,Redding,2016,3811,0,0,9,0,9,0.24
118,Ridgefield,2016,9420,179,5,26,59,269,2.86
119,Rocky Hill,2016,8843,235,31,148,0,414,4.68
120,Roxbury,2016,1167,19,0,3,0,22,1.89
121,Salem,2016,1635,3,2,23,0,28,1.71
122,Salisbury,2016,2593,16,1,1,13,31,1.2
123,Scotland,2016,680,0,0,17,0,17,2.5
124,Seymour,2016,6968,262,23,97,0,382,5.48
125,Sharon,2016,1775,32,3,2,0,37,2.08
126,Shelton,2016,16146,253,38,97,82,470,2.91
127,Sherman,2016,1831,0,2,6,0,8,0.44
128,Simsbury,2016,9123,289,61,59,0,409,4.48
129,Somers,2016,3479,146,7,30,0,183,5.26
132,South Windsor,2016,10243,427,50,185,0,662,6.46
130,Southbury,2016,9091,89,7,29,0,125,1.37
131,Southington,2016,17447,502,49,266,51,868,4.98
133,Sprague,2016,1248,20,14,36,0,70,5.61
134,Stafford,2016,5124,257,13,135,0,405,7.9
135,Stamford,2016,50573,4744,1753,332,1274,8103,16.02
136,Sterling,2016,1511,0,7,33,0,40,2.65
137,Stonington,2016,9467,382,16,60,0,458,4.84
138,Stratford,2016,21091,524,421,281,33,1259,5.97
139,Suffield,2016,5469,212,2,47,15,276,5.05
140,Thomaston,2016,3276,104,6,76,0,186,5.68
141,Thompson,2016,4171,151,16,79,0,246,5.9
142,Tolland,2016,5451,89,3,66,3,161,2.95
143,Torrington,2016,16761,908,390,495,17,1810,10.8
144,Trumbull,2016,13157,315,15,58,210,598,4.55
145,Union,2016,388,0,0,4,0,4,1.03
146,Vernon,2016,13896,1440,399,329,12,2180,15.69
147,Voluntown,2016,1127,20,3,26,0,49,4.35
148,Wallingford,2016,18945,354,116,253,35,758,4
149,Warren,2016,811,0,0,1,0,1,0.12
150,Washington,2016,2124,14,5,10,23,52,2.45
151,Waterbury,2016,47991,5257,2969,1800,172,10198,21.25
152,Waterford,2016,8634,123,20,219,0,362,4.19
153,Watertown,2016,9096,205,23,159,0,387,4.25
155,West Hartford,2016,26396,587,786,287,268,1928,7.3
156,West Haven,2016,22446,1024,1476,411,0,2911,12.97
154,Westbrook,2016,3937,140,8,18,29,195,4.95
157,Weston,2016,3674,0,1,2,0,3,0.08
158,Westport,2016,10399,246,54,4,20,324,3.12
159,Wethersfield,2016,11677,615,99,231,0,945,8.09
160,Willington,2016,2637,160,4,33,0,197,7.47
161,Wilton,2016,6475,136,8,10,104,258,3.98
162,Winchester,2016,5613,348,187,121,0,656,11.69
163,Windham,2016,9570,1747,608,416,0,2771,28.96
164,Windsor,2016,11767,154,221,368,26,769,6.54
165,Windsor Locks,2016,5429,137,147,176,0,460,8.47
166,Wolcott,2016,6276,312,7,124,0,443,7.06
167,Woodbridge,2016,3478,30,6,5,0,41,1.18
168,Woodbury,2016,4564,59,3,22,0,84,1.84
169,Woodstock,2016,3582,24,1,49,0,74,2.07
1,Andover,2015,1317,24,0,31,0,55,4.18
2,Ansonia,2015,8148,371,654,125,9,1159,14.22
3,Ashford,2015,1903,32,2,45,0,79,4.15
4,Avon,2015,7389,244,7,32,0,283,3.83
5,Barkhamsted,2015,1589,0,5,15,0,20,1.26
6,Beacon Falls,2015,2509,0,3,38,0,41,1.63
7,Berlin,2015,8140,556,43,110,10,719,8.83
8,Bethany,2015,2044,0,1,5,1,7,0.34
9,Bethel,2015,7310,212,15,80,63,370,5.06
10,Bethlehem,2015,1575,24,0,2,0,26,1.65
11,Bloomfield,2015,9019,591,90,328,0,1009,11.19
12,Bolton,2015,2015,0,2,23,0,25,1.24
12,Bolton,2015,0,3,20,0,23,1.14,
13,Bozrah,2015,1059,0,2,31,0,33,3.12
14,Branford,2015,13972,231,60,193,0,484,3.46
15,Bridgeport,2015,57012,6275,3983,1062,19,11339,19.89
16,Bridgewater,2015,881,0,0,4,0,4,0.45
17,Bristol,2015,27011,1913,780,1147,0,3840,14.22
18,Brookfield,2015,6562,83,8,60,70,221,3.37
19,Brooklyn,2015,3235,231,11,116,0,358,11.07
20,Burlington,2015,3389,27,0,39,0,66,1.95
21,Canaan,2015,779,35,2,16,1,54,6.93
22,Canterbury,2015,2043,76,1,62,0,139,6.8
23,Canton,2015,4339,211,14,71,32,328,7.56
24,Chaplin,2015,988,0,0,32,0,32,3.24
25,Cheshire,2015,10424,277,16,85,17,395,3.79
26,Chester,2015,1923,23,3,14,0,40,2.08
27,Clinton,2015,6065,84,13,46,0,143,2.36
28,Colchester,2015,6182,364,34,133,0,531,8.59
29,Colebrook,2015,722,0,0,8,1,9,1.25
30,Columbia,2015,2308,40,3,61,0,104,4.51
31,Cornwall,2015,1007,28,2,4,0,34,3.38
32,Coventry,2015,5099,103,3,173,20,299,5.86
33,Cromwell,2015,6001,212,9,231,0,452,7.53
34,Danbury,2015,31154,1588,909,414,296,3207,10.29
35,Darien,2015,7074,136,6,1,95,238,3.36
36,Deep River,2015,2096,26,2,26,0,54,2.58
37,Derby,2015,5849,275,322,77,0,674,11.52
38,Durham,2015,2694,36,1,15,0,52,1.93
40,East Granby,2015,2152,72,1,40,0,113,5.25
41,East Haddam,2015,4508,73,3,38,0,114,2.53
42,East Hampton,2015,5485,70,8,100,25,203,3.7
43,East Hartford,2015,21328,1700,759,1024,0,3483,16.33
44,East Haven,2015,12533,542,139,339,0,1020,8.14
45,East Lyme,2015,8458,396,12,107,19,534,6.31
47,East Windsor,2015,5045,559,33,130,14,736,14.59
39,Eastford,2015,793,0,0,23,0,23,2.9
46,Easton,2015,2715,0,0,0,15,15,0.55
48,Ellington,2015,6665,260,5,117,0,382,5.73
49,Enfield,2015,17558,1340,199,648,7,2194,12.5
50,Essex,2015,3261,36,5,9,0,50,1.53
51,Fairfield,2015,21648,241,104,46,112,503,2.32
52,Farmington,2015,11106,496,107,143,155,901,8.11
53,Franklin,2015,771,27,0,21,0,48,6.23
54,Glastonbury,2015,13656,583,33,141,2,759,5.56
55,Goshen,2015,1664,1,1,7,0,9,0.54
56,Granby,2015,4360,85,1,51,5,142,3.26
57,Greenwich,2015,25631,969,337,3,54,1363,5.32
58,Griswold,2015,5118,148,74,209,0,431,8.42
59,Groton,2015,17978,3588,93,385,10,4076,22.67
60,Guilford,2015,9596,186,7,40,0,233,2.43
61,Haddam,2015,3504,22,0,20,0,42,1.2
62,Hamden,2015,25114,902,554,529,4,1989,7.92
63,Hampton,2015,793,0,1,36,0,37,4.67
64,Hartford,2015,51822,10697,8532,1621,0,20850,40.23
65,Hartland,2015,856,2,0,7,0,9,1.05
66,Harwinton,2015,2282,22,2,35,0,59,2.59
67,Hebron,2015,3567,58,2,44,0,104,2.92
68,Kent,2015,1665,53,4,4,0,61,3.66
69,Killingly,2015,7592,527,106,417,0,1050,13.83
70,Killingworth,2015,2598,0,0,15,5,20,0.77
71,Lebanon,2015,3125,26,4,79,0,109,3.49
72,Ledyard,2015,5987,32,6,222,0,260,4.34
73,Lisbon,2015,1730,2,0,58,0,60,3.47
74,Litchfield,2015,3975,140,5,22,29,196,4.93
75,Lyme,2015,1223,0,0,2,8,10,0.82
76,Madison,2015,8049,90,2,9,29,130,1.62
77,Manchester,2015,25996,1878,839,1013,34,3764,14.48
78,Mansfield,2015,6017,417,121,111,2,651,10.82
79,Marlborough,2015,2389,24,2,24,0,50,2.09
80,Meriden,2015,25892,2027,1102,1128,11,4268,16.48
83,Middletown,2015,21223,3142,1121,655,25,4943,23.29
84,Milford,2015,23074,726,211,242,87,1266,5.49
85,Monroe,2015,6918,32,3,29,1,65,0.94
86,Montville,2015,7407,81,37,257,0,375,5.06
87,Morris,2015,1314,20,4,1,0,25,1.9
88,Naugatuck,2015,13061,537,260,337,0,1134,8.68
89,New Britain,2015,31226,3331,1423,1271,256,6281,20.11
90,New Canaan,2015,7551,163,10,3,23,199,2.64
91,New Fairfield,2015,5593,0,1,38,13,52,0.93
92,New Hartford,2015,2923,12,6,46,15,79,2.7
93,New Haven,2015,54967,9124,5654,1240,602,16620,30.24
95,New London,2015,11840,1709,449,517,102,2777,23.45
96,New Milford,2015,11731,307,24,151,16,498,4.25
94,Newington,2015,13011,531,104,453,36,1124,8.64
97,Newtown,2015,10061,134,3,43,15,195,1.94
98,Norfolk,2015,967,28,3,6,0,37,3.83
99,North Branford,2015,5629,62,11,63,0,136,2.42
100,North Canaan,2015,1587,138,1,10,0,149,9.39
101,North Haven,2015,9491,343,40,91,0,474,4.99
102,North Stonington,2015,2306,0,2,29,0,31,1.34
103,Norwalk,2015,35415,2328,1065,304,666,4363,12.32
104,Norwich,2015,18659,2225,762,589,0,3576,19.17
105,Old Lyme,2015,5021,60,3,9,3,75,1.49
106,Old Saybrook,2015,5602,50,7,20,20,97,1.73
107,Orange,2015,5345,46,6,13,6,71,1.33
108,Oxford,2015,4746,36,4,18,0,58,1.22
109,Plainfield,2015,6229,377,180,382,0,939,15.07
110,Plainville,2015,8063,242,22,332,22,618,7.66
111,Plymouth,2015,5109,178,10,210,0,398,7.79
112,Pomfret,2015,1684,32,1,22,0,55,3.27
113,Portland,2015,4077,185,83,73,0,341,8.36
114,Preston,2015,2019,40,5,45,0,90,4.46
115,Prospect,2015,3474,0,4,38,0,42,1.21
116,Putnam,2015,4299,383,65,170,0,618,14.38
117,Redding,2015,3811,0,0,1,0,1,0.03
118,Ridgefield,2015,9420,179,3,15,59,256,2.72
119,Rocky Hill,2015,8843,235,25,194,0,454,5.13
120,Roxbury,2015,1167,19,0,2,0,21,1.8
121,Salem,2015,1635,1,0,31,0,32,1.96
122,Salisbury,2015,2593,16,2,5,12,35,1.35
123,Scotland,2015,680,0,0,17,0,17,2.5
124,Seymour,2015,6968,262,21,113,0,396,5.68
125,Sharon,2015,1775,20,2,4,0,26,1.46
126,Shelton,2015,16146,344,42,103,82,571,3.54
127,Sherman,2015,1831,0,2,4,0,6,0.33
128,Simsbury,2015,9123,241,19,79,0,339,3.72
129,Somers,2015,3479,146,10,33,0,189,5.43
130,Southbury,2015,9091,90,6,25,0,121,1.33
133,Sprague,2015,1248,20,13,39,0,72,5.77
134,Stafford,2015,5124,257,10,205,0,472,9.21
135,Stamford,2015,50573,5031,1836,361,1274,8502,16.81
136,Sterling,2015,1511,0,6,44,0,50,3.31
137,Stonington,2015,9467,383,16,72,0,471,4.98
138,Stratford,2015,21091,524,392,311,33,1260,5.97
139,Suffield,2015,5469,212,2,68,15,297,5.43
140,Thomaston,2015,3276,104,4,118,0,226,6.9
141,Thompson,2015,4171,151,11,112,0,274,6.57
142,Tolland,2015,5451,96,3,89,3,191,3.5
143,Torrington,2015,16761,1112,316,668,17,2113,12.61
144,Trumbull,2015,13157,315,16,47,210,588,4.47
145,Union,2015,388,0,0,10,0,10,2.58
146,Vernon,2015,13896,1470,371,411,12,2264,16.29
147,Voluntown,2015,1127,20,4,30,0,54,4.79
148,Wallingford,2015,18945,481,116,337,35,969,5.11
149,Warren,2015,811,0,0,5,0,5,0.62
150,Washington,2015,2124,14,5,4,23,46,2.17
151,Waterbury,2015,47991,5561,2904,2429,172,11066,23.06
152,Waterford,2015,8634,123,21,259,0,403,4.67
153,Watertown,2015,9096,205,22,167,0,394,4.33
155,West Hartford,2015,26396,621,720,357,283,1981,7.5
156,West Haven,2015,22446,1024,1438,468,0,2930,13.05
154,Westbrook,2015,3937,140,7,17,24,188,4.78
157,Weston,2015,3674,0,1,2,0,3,0.08
158,Westport,2015,10399,246,50,3,20,319,3.07
159,Wethersfield,2015,11677,615,96,278,0,989,8.47
160,Willington,2015,2637,160,1,47,0,208,7.89
161,Wilton,2015,6475,136,6,8,104,254,3.92
162,Winchester,2015,5613,348,214,161,0,723,12.88
163,Windham,2015,9570,1862,596,534,0,2992,31.26
164,Windsor,2015,11767,154,207,437,26,824,7
165,Windsor Locks,2015,5429,137,140,209,0,486,8.95
166,Wolcott,2015,6276,313,5,153,0,471,7.5
167,Woodbridge,2015,3478,30,5,6,0,41,1.18
168,Woodbury,2015,4564,59,3,26,0,88,1.93
169,Woodstock,2015,3582,24,2,72,0,98,2.74
1,Andover,2014,1317,24,1,32,0,57,4.33
2,Ansonia,2014,8148,371,642,112,9,1134,13.92
3,Ashford,2014,1903,32,2,50,0,84,4.41
4,Avon,2014,7389,244,8,26,0,278,3.76
5,Barkhamsted,2014,1589,0,4,13,0,17,1.07
6,Beacon Falls,2014,2509,0,2,31,0,33,1.32
7,Berlin,2014,8140,556,43,94,6,699,8.59
8,Bethany,2014,2044,0,0,2,1,3,0.15
9,Bethel,2014,7310,252,15,66,64,397,5.43
10,Bethlehem,2014,1575,24,0,1,0,25,1.59
11,Bloomfield,2014,9019,591,149,311,0,1051,11.65
12,Bolton,2014,2015,0,3,23,0,26,1.29
13,Bozrah,2014,1059,0,2,34,0,36,3.4
14,Branford,2014,13972,243,56,179,0,478,3.42
15,Bridgeport,2014,57012,5870,3779,1036,20,10705,18.78
16,Bridgewater,2014,881,0,0,2,0,2,0.23
17,Bristol,2014,27011,1633,823,1065,0,3521,13.04
18,Brookfield,2014,6562,35,7,48,70,160,2.44
19,Brooklyn,2014,3235,231,12,135,0,378,11.68
20,Burlington,2014,3389,27,0,34,0,61,1.8
21,Canaan,2014,779,25,3,30,1,59,7.57
22,Canterbury,2014,2043,76,0,79,0,155,7.59
23,Canton,2014,4339,211,17,68,32,328,7.56
24,Chaplin,2014,988,0,0,36,0,36,3.64
25,Cheshire,2014,10424,277,12,78,17,384,3.68
26,Chester,2014,1923,23,3,12,0,38,1.98
27,Clinton,2014,6065,84,9,47,0,140,2.31
28,Colchester,2014,6182,364,34,145,0,543,8.78
29,Colebrook,2014,722,0,0,10,1,11,1.52
30,Columbia,2014,2308,24,3,63,0,90,3.9
31,Cornwall,2014,1007,18,2,3,0,23,2.28
32,Coventry,2014,5099,103,1,176,20,300,5.88
33,Cromwell,2014,6001,212,13,203,0,428,7.13
34,Danbury,2014,31154,1587,904,344,296,3131,10.05
35,Darien,2014,7074,136,7,1,95,239,3.38
36,Deep River,2014,2096,26,24,26,0,76,3.63
37,Derby,2014,5849,275,314,69,0,658,11.25
38,Durham,2014,2694,36,4,14,0,54,2
40,East Granby,2014,2152,72,2,35,0,109,5.07
41,East Haddam,2014,4508,73,1,47,1,122,2.71
42,East Hampton,2014,5485,70,5,98,25,198,3.61
43,East Hartford,2014,21328,1700,1054,952,0,3706,17.38
44,East Haven,2014,12533,542,141,307,0,990,7.9
45,East Lyme,2014,8458,396,10,95,19,520,6.15
47,East Windsor,2014,5045,559,43,119,14,735,14.57
39,Eastford,2014,793,0,0,24,0,24,3.03
46,Easton,2014,2715,0,0,0,11,11,0.41
48,Ellington,2014,6665,260,9,106,0,375,5.63
49,Enfield,2014,17558,1340,211,581,7,2139,12.18
50,Essex,2014,3261,36,5,12,0,53,1.63
51,Fairfield,2014,21648,241,94,34,116,485,2.24
52,Farmington,2014,11106,496,110,123,155,884,7.96
53,Franklin,2014,771,27,0,16,0,43,5.58
54,Glastonbury,2014,13656,583,37,124,2,746,5.46
55,Goshen,2014,1664,1,0,9,0,10,0.6
56,Granby,2014,4360,85,1,47,5,138,3.17
57,Greenwich,2014,25631,839,334,2,54,1229,4.79
58,Griswold,2014,5118,153,67,237,0,457,8.93
59,Groton,2014,17978,3589,76,369,10,4044,22.49
60,Guilford,2014,9596,177,7,36,0,220,2.29
61,Haddam,2014,3504,22,0,25,0,47,1.34
62,Hamden,2014,25114,903,545,477,4,1929,7.68
63,Hampton,2014,793,0,2,42,0,44,5.55
64,Hartford,2014,51822,10299,7812,1523,0,19634,37.89
65,Hartland,2014,856,2,1,8,0,11,1.29
66,Harwinton,2014,2282,22,0,36,0,58,2.54
67,Hebron,2014,3567,58,3,46,0,107,3
68,Kent,2014,1665,52,4,4,0,60,3.6
69,Killingly,2014,7592,495,107,488,0,1090,14.36
70,Killingworth,2014,2598,0,0,11,5,16,0.62
71,Lebanon,2014,3125,26,5,88,0,119,3.81
72,Ledyard,2014,5987,32,5,204,0,241,4.03
73,Lisbon,2014,1730,2,0,57,0,59,3.41
74,Litchfield,2014,3975,140,5,28,29,202,5.08
75,Lyme,2014,1223,0,0,2,8,10,0.82
76,Madison,2014,8049,90,1,10,29,130,1.62
77,Manchester,2014,25996,1834,977,923,36,3770,14.5
78,Mansfield,2014,6017,417,125,117,2,661,10.99
79,Marlborough,2014,2389,24,2,23,0,49,2.05
80,Meriden,2014,25892,2027,1033,1065,11,4136,15.97
81,Middlebury,2014,2892,77,3,15,20,115,3.98
82,Middlefield,2014,1863,30,2,13,1,46,2.47
83,Middletown,2014,21223,2974,1047,614,25,4660,21.96
84,Milford,2014,23074,726,212,220,107,1265,5.48
85,Monroe,2014,6918,32,3,23,1,59,0.85
86,Montville,2014,7407,81,28,240,0,349,4.71
87,Morris,2014,1314,20,4,1,0,25,1.9
88,Naugatuck,2014,13061,537,368,311,0,1216,9.31
89,New Britain,2014,31226,3421,1602,1192,382,6597,21.13
90,New Canaan,2014,7551,163,9,2,31,205,2.71
91,New Fairfield,2014,5593,0,0,27,13,40,0.72
92,New Hartford,2014,2923,12,5,46,15,78,2.67
93,New Haven,2014,54967,8880,5336,1188,581,15985,29.08
95,New London,2014,11840,1685,674,487,98,2944,24.86
96,New Milford,2014,11731,269,27,147,16,459,3.91
94,Newington,2014,13011,537,148,390,36,1111,8.54
97,Newtown,2014,10061,134,3,29,15,181,1.8
98,Norfolk,2014,967,28,2,9,0,39,4.03
99,North Branford,2014,5629,62,10,62,0,134,2.38
100,North Canaan,2014,1587,138,1,8,0,147,9.26
101,North Haven,2014,9491,343,36,76,1,456,4.8
102,North Stonington,2014,2306,0,2,22,0,24,1.04
103,Norwalk,2014,35415,2334,997,261,599,4191,11.83
104,Norwich,2014,18659,2109,721,554,0,3384,18.14
105,Old Lyme,2014,5021,64,2,9,3,78,1.55
106,Old Saybrook,2014,5602,50,7,19,20,96,1.71
107,Orange,2014,5345,46,6,10,6,68,1.27
108,Oxford,2014,4746,36,3,12,0,51,1.07
109,Plainfield,2014,6229,377,166,460,0,1003,16.1
110,Plainville,2014,8063,242,21,311,22,596,7.39
111,Plymouth,2014,5109,178,18,224,0,420,8.22
112,Pomfret,2014,1684,32,1,28,0,61,3.62
113,Portland,2014,4077,185,82,64,0,331,8.12
114,Preston,2014,2019,40,5,44,0,89,4.41
115,Prospect,2014,3474,0,4,38,0,42,1.21
116,Putnam,2014,4299,383,69,208,0,660,15.35
117,Redding,2014,3811,0,0,0,0,0,0
118,Ridgefield,2014,9420,179,1,9,48,237,2.52
119,Rocky Hill,2014,8843,235,30,179,0,444,5.02
120,Roxbury,2014,1167,19,0,1,0,20,1.71
121,Salem,2014,1635,1,0,34,0,35,2.14
122,Salisbury,2014,2593,16,2,7,12,37,1.43
123,Scotland,2014,680,0,0,13,0,13,1.91
124,Seymour,2014,6968,262,18,97,0,377,5.41
125,Sharon,2014,1775,20,2,4,0,26,1.46
126,Shelton,2014,16146,344,34,87,82,547,3.39
127,Sherman,2014,1831,0,2,3,0,5,0.27
128,Simsbury,2014,9123,241,19,62,0,322,3.53
129,Somers,2014,3479,146,12,31,0,189,5.43
132,South Windsor,2014,10243,427,49,239,0,715,6.98
130,Southbury,2014,9091,90,4,18,0,112,1.23
75,Lyme,2012,1223,0,0,2,8,10,0.82
131,Southington,2014,17447,609,67,295,51,1022,5.86
133,Sprague,2014,1248,20,13,47,0,80,6.41
134,Stafford,2014,5124,178,13,231,0,422,8.24
135,Stamford,2014,50573,4862,1732,326,1295,8215,16.24
136,Sterling,2014,1511,0,6,61,0,67,4.43
137,Stonington,2014,9467,297,15,71,0,383,4.05
138,Stratford,2014,21091,524,381,278,33,1216,5.77
139,Suffield,2014,5469,212,3,64,15,294,5.38
140,Thomaston,2014,3276,104,4,115,0,223,6.81
141,Thompson,2014,4171,151,25,133,0,309,7.41
142,Tolland,2014,5451,98,2,93,3,196,3.6
143,Torrington,2014,16761,1112,277,639,17,2045,12.2
144,Trumbull,2014,13157,315,15,36,317,683,5.19
145,Union,2014,388,0,0,12,0,12,3.09
146,Vernon,2014,13896,1387,391,374,12,2164,15.57
147,Voluntown,2014,1127,20,4,38,0,62,5.5
148,Wallingford,2014,18945,481,115,310,35,941,4.97
149,Warren,2014,811,0,0,5,0,5,0.62
150,Washington,2014,2124,14,6,7,23,50,2.35
151,Waterbury,2014,47991,5171,3074,2327,326,10898,22.71
152,Waterford,2014,8634,123,20,239,0,382,4.42
153,Watertown,2014,9096,205,18,145,0,368,4.05
155,West Hartford,2014,26396,621,832,316,287,2056,7.79
156,West Haven,2014,22446,1024,1451,429,0,2904,12.94
154,Westbrook,2014,3937,140,7,17,24,188,4.78
157,Weston,2014,3674,0,1,0,0,1,0.03
158,Westport,2014,10399,246,45,2,20,313,3.01
159,Wethersfield,2014,11677,615,134,231,0,980,8.39
160,Willington,2014,2637,160,1,46,0,207,7.85
161,Wilton,2014,6475,136,7,7,100,250,3.86
162,Winchester,2014,5613,348,444,187,0,979,17.44
163,Windham,2014,9570,1862,541,575,0,2978,31.12
164,Windsor,2014,11767,154,297,401,26,878,7.46
165,Windsor Locks,2014,5429,137,153,187,0,477,8.79
166,Wolcott,2014,6276,313,4,131,0,448,7.14
167,Woodbridge,2014,3478,30,5,6,0,41,1.18
168,Woodbury,2014,4564,59,2,25,0,86,1.88
169,Woodstock,2014,3582,24,3,72,0,99,2.76
1,Andover,2013,1317,24,1,29,0,54,4.1
2,Ansonia,2013,8148,371,756,112,9,1248,15.32
3,Ashford,2013,1903,32,2,48,0,82,4.31
4,Avon,2013,7389,244,7,29,0,280,3.79
5,Barkhamsted,2013,1589,0,1,15,0,16,1.01
6,Beacon Falls,2013,2509,0,5,32,0,37,1.47
7,Berlin,2013,8140,556,29,93,6,684,8.4
8,Bethany,2013,2044,0,0,2,1,3,0.15
9,Bethel,2013,7310,252,10,64,63,389,5.32
10,Bethlehem,2013,1575,24,1,1,0,26,1.65
11,Bloomfield,2013,9019,592,147,306,0,1045,11.59
12,Bolton,2013,2015,0,3,20,0,23,1.14
13,Bozrah,2013,1059,0,4,29,0,33,3.12
14,Branford,2013,13972,243,50,179,0,472,3.38
15,Bridgeport,2013,57012,5738,3781,1014,20,10553,18.51
16,Bridgewater,2013,881,0,0,2,0,2,0.23
17,Bristol,2013,27011,1771,798,1065,0,3634,13.45
18,Brookfield,2013,6562,35,7,55,63,160,2.44
19,Brooklyn,2013,3235,232,11,135,0,378,11.68
20,Burlington,2013,3389,28,0,41,0,69,2.04
21,Canaan,2013,779,25,0,10,1,36,4.62
22,Canterbury,2013,2043,76,1,69,0,146,7.15
23,Canton,2013,4339,211,19,63,32,325,7.49
24,Chaplin,2013,988,0,0,28,0,28,2.83
25,Cheshire,2013,10424,237,7,76,17,337,3.23
26,Chester,2013,1923,23,2,13,0,38,1.98
27,Clinton,2013,6065,84,5,48,0,137,2.26
28,Colchester,2013,6182,364,31,125,0,520,8.41
29,Colebrook,2013,722,0,0,8,1,9,1.25
30,Columbia,2013,2308,24,2,60,0,86,3.73
31,Cornwall,2013,1007,18,0,6,0,24,2.38
32,Coventry,2013,5099,104,1,182,20,307,6.02
33,Cromwell,2013,6001,212,6,200,0,418,6.97
34,Danbury,2013,31154,1586,1180,344,295,3405,10.93
35,Darien,2013,7074,83,6,1,95,185,2.62
36,Deep River,2013,2096,26,5,27,0,58,2.77
37,Derby,2013,5849,259,307,68,0,634,10.84
38,Durham,2013,2694,34,1,21,0,56,2.08
39,Eastford,2013,793,0,0,25,0,25,3.15
40,East Granby,2013,2152,72,4,37,0,113,5.25
41,East Haddam,2013,4508,73,0,42,1,116,2.57
42,East Hampton,2013,5485,70,5,100,25,200,3.65
43,East Hartford,2013,21328,1578,1024,950,0,3552,16.65
44,East Haven,2013,12533,422,128,307,0,857,6.84
45,East Lyme,2013,8458,344,8,102,19,473,5.59
46,Easton,2013,2715,0,0,0,11,11,0.41
47,East Windsor,2013,5045,558,49,127,14,748,14.83
48,Ellington,2013,6665,260,8,125,0,393,5.9
49,Enfield,2013,17558,1340,215,581,7,2143,12.21
50,Essex,2013,3261,36,6,13,0,55,1.69
51,Fairfield,2013,21648,241,181,34,116,572,2.64
52,Farmington,2013,11106,469,110,124,155,858,7.73
53,Franklin,2013,771,0,1,20,0,21,2.72
54,Glastonbury,2013,13656,582,47,124,2,755,5.53
55,Goshen,2013,1664,1,0,7,0,8,0.48
56,Granby,2013,4360,85,2,60,5,152,3.49
57,Greenwich,2013,25631,837,421,2,54,1314,5.13
58,Griswold,2013,5118,153,41,222,0,416,8.13
59,Groton,2013,17978,3267,52,361,10,3690,20.53
60,Guilford,2013,9596,168,6,42,0,216,2.25
61,Haddam,2013,3504,22,1,21,0,44,1.26
62,Hamden,2013,25114,685,523,477,4,1689,6.73
63,Hampton,2013,793,0,0,32,0,32,4.04
64,Hartford,2013,51822,9540,8525,1523,0,19588,37.8
65,Hartland,2013,856,2,0,10,0,12,1.4
66,Harwinton,2013,2282,22,0,35,0,57,2.5
67,Hebron,2013,3567,59,3,46,0,108,3.03
68,Kent,2013,1665,24,0,4,0,28,1.68
69,Killingly,2013,7592,530,125,479,0,1134,14.94
70,Killingworth,2013,2598,0,2,10,5,17,0.65
71,Lebanon,2013,3125,26,4,79,0,109,3.49
72,Ledyard,2013,5987,32,6,226,0,264,4.41
73,Lisbon,2013,1730,2,0,64,0,66,3.82
74,Litchfield,2013,3975,140,1,16,29,186,4.68
75,Lyme,2013,1223,0,0,2,8,10,0.82
76,Madison,2013,8049,90,1,10,29,130,1.62
77,Manchester,2013,25996,1833,1074,925,36,3868,14.88
78,Mansfield,2013,6017,417,153,108,2,680,11.3
79,Marlborough,2013,2389,24,0,29,0,53,2.22
80,Meriden,2013,25892,1745,1012,1065,11,3833,14.8
81,Middlebury,2013,2892,76,4,20,8,108,3.73
82,Middlefield,2013,1863,30,1,12,1,44,2.36
83,Middletown,2013,21223,2859,1467,614,25,4965,23.39
84,Milford,2013,23074,822,277,220,107,1426,6.18
85,Monroe,2013,6918,32,1,25,1,59,0.85
86,Montville,2013,7407,81,30,262,0,373,5.04
87,Morris,2013,1314,20,2,1,0,23,1.75
88,Naugatuck,2013,13061,493,293,311,0,1097,8.4
89,New Britain,2013,31226,3266,1627,1192,382,6467,20.71
90,New Canaan,2013,7551,162,10,2,31,205,2.71
91,New Fairfield,2013,5593,0,0,36,13,49,0.88
92,New Hartford,2013,2923,12,1,42,15,70,2.39
93,New Haven,2013,54967,8261,6232,1188,605,16286,29.63
94,Newington,2013,13011,425,105,390,36,956,7.35
95,New London,2013,11840,1672,144,482,83,2381,20.11
96,New Milford,2013,11731,233,259,172,16,680,5.8
97,Newtown,2013,10061,134,2,35,15,186,1.85
98,Norfolk,2013,967,28,0,3,0,31,3.21
99,North Branford,2013,5629,62,7,62,0,131,2.33
100,North Canaan,2013,1587,101,0,8,0,109,6.87
101,North Haven,2013,9491,343,28,76,1,448,4.72
102,North Stonington,2013,2306,0,1,28,0,29,1.26
103,Norwalk,2013,35415,2299,957,261,599,4116,11.62
104,Norwich,2013,18659,1972,728,550,0,3250,17.42
105,Old Lyme,2013,5021,60,1,11,3,75,1.49
106,Old Saybrook,2013,5602,50,5,18,19,92,1.64
107,Orange,2013,5345,46,4,10,6,66,1.23
108,Oxford,2013,4746,36,1,14,0,51,1.07
109,Plainfield,2013,6229,378,224,386,0,988,15.86
110,Plainville,2013,8063,242,25,311,22,600,7.44
111,Plymouth,2013,5109,179,5,179,0,363,7.11
112,Pomfret,2013,1684,32,2,28,0,62,3.68
113,Portland,2013,4077,185,92,62,0,339,8.31
114,Preston,2013,2019,40,4,47,0,91,4.51
115,Prospect,2013,3474,0,4,34,0,38,1.09
116,Putnam,2013,4299,383,79,200,0,662,15.4
117,Redding,2013,3811,0,0,0,0,0,0
118,Ridgefield,2013,9420,179,0,9,42,230,2.44
119,Rocky Hill,2013,8843,236,29,179,0,444,5.02
120,Roxbury,2013,1167,19,0,2,0,21,1.8
121,Salem,2013,1635,1,0,34,0,35,2.14
122,Salisbury,2013,2593,16,1,7,10,34,1.31
123,Scotland,2013,680,0,0,16,0,16,2.35
124,Seymour,2013,6968,262,16,103,0,381,5.47
125,Sharon,2013,1775,20,0,4,0,24,1.35
126,Shelton,2013,16146,254,21,87,82,444,2.75
127,Sherman,2013,1831,0,1,3,0,4,0.22
128,Simsbury,2013,9123,241,11,62,0,314,3.44
129,Somers,2013,3479,146,7,29,0,182,5.23
130,Southbury,2013,9091,89,2,23,0,114,1.25
131,Southington,2013,17447,609,42,295,51,997,5.71
132,South Windsor,2013,10243,427,54,239,0,720,7.03
133,Sprague,2013,1248,20,9,35,0,64,5.13
134,Stafford,2013,5124,178,11,198,0,387,7.55
135,Stamford,2013,50573,4863,1631,326,1295,8115,16.05
136,Sterling,2013,1511,0,1,61,0,62,4.1
137,Stonington,2013,9467,296,17,66,0,379,4
138,Stratford,2013,21091,524,375,278,33,1210,5.74
139,Suffield,2013,5469,212,0,70,15,297,5.43
140,Thomaston,2013,3276,105,4,117,0,226,6.9
141,Thompson,2013,4171,151,13,159,0,323,7.74
142,Tolland,2013,5451,97,1,110,3,211,3.87
143,Torrington,2013,16761,1112,355,639,17,2123,12.67
144,Trumbull,2013,13157,315,12,36,314,677,5.15
145,Union,2013,388,0,0,16,0,16,4.12
146,Vernon,2013,13896,1387,533,374,12,2306,16.59
147,Voluntown,2013,1127,20,2,31,0,53,4.7
148,Wallingford,2013,18945,482,140,310,35,967,5.1
149,Warren,2013,811,0,0,8,0,8,0.99
150,Washington,2013,2124,14,0,1,23,38,1.79
151,Waterbury,2013,47991,4901,3635,2327,326,11189,23.31
152,Waterford,2013,8634,123,17,250,0,390,4.52
153,Watertown,2013,9096,206,24,145,0,375,4.12
154,Westbrook,2013,3937,140,8,15,24,187,4.75
155,West Hartford,2013,26396,590,943,316,287,2136,8.09
156,West Haven,2013,22446,1024,1613,429,0,3066,13.66
157,Weston,2013,3674,0,1,0,0,1,0.03
158,Westport,2013,10399,245,20,2,19,286,2.75
159,Wethersfield,2013,11677,625,127,231,0,983,8.42
160,Willington,2013,2637,160,2,50,0,212,8.04
161,Wilton,2013,6475,135,5,7,100,247,3.81
162,Winchester,2013,5613,316,269,150,0,735,13.09
163,Windham,2013,9570,1752,533,490,0,2775,29
164,Windsor,2013,11767,154,282,399,26,861,7.32
165,Windsor Locks,2013,5429,137,178,187,0,502,9.25
166,Wolcott,2013,6276,312,3,131,0,446,7.11
167,Woodbridge,2013,3478,30,3,6,0,39,1.12
168,Woodbury,2013,4564,60,4,25,0,89,1.95
169,Woodstock,2013,3582,24,3,87,0,114,3.18
1,Andover,2012,1317,24,1,22,0,47,3.57
2,Ansonia,2012,8148,372,699,106,9,1186,14.56
3,Ashford,2012,1903,32,2,37,0,71,3.73
4,Avon,2012,7389,240,7,23,0,270,3.65
5,Barkhamsted,2012,1589,0,1,12,0,13,0.82
6,Beacon Falls,2012,2509,0,5,26,0,31,1.24
7,Berlin,2012,8140,468,29,82,6,585,7.19
8,Bethany,2012,2044,0,0,1,1,2,0.1
9,Bethel,2012,7310,250,10,57,63,380,5.2
10,Bethlehem,2012,1575,24,1,0,0,25,1.59
11,Bloomfield,2012,9019,584,147,295,0,1026,11.38
12,Bolton,2012,2015,0,3,16,0,19,0.94
13,Bozrah,2012,1059,0,4,19,0,23,2.17
14,Branford,2012,13972,232,50,174,0,456,3.26
15,Bridgeport,2012,57012,5604,3498,964,20,10086,17.69
16,Bridgewater,2012,881,0,0,2,0,2,0.23
17,Bristol,2012,27011,1771,793,1014,0,3578,13.25
18,Brookfield,2012,6562,35,7,42,55,139,2.12
19,Brooklyn,2012,3235,233,11,80,0,324,10.02
20,Burlington,2012,3389,28,0,29,0,57,1.68
21,Canaan,2012,779,25,0,9,1,35,4.49
22,Canterbury,2012,2043,76,1,40,0,117,5.73
23,Canton,2012,4339,211,19,55,32,317,7.31
24,Chaplin,2012,988,0,0,24,0,24,2.43
25,Cheshire,2012,10424,237,7,70,17,331,3.18
26,Chester,2012,1923,23,2,10,0,35,1.82
27,Clinton,2012,6065,84,5,43,0,132,2.18
28,Colchester,2012,6182,364,31,93,0,488,7.89
29,Colebrook,2012,722,0,0,7,1,8,1.11
30,Columbia,2012,2308,24,2,43,0,69,2.99
31,Cornwall,2012,1007,18,0,2,0,20,1.99
32,Coventry,2012,5099,104,1,136,20,261,5.12
33,Cromwell,2012,6001,212,6,199,0,417,6.95
34,Danbury,2012,31154,1586,1181,315,192,3274,10.51
35,Darien,2012,7074,83,6,1,93,183,2.59
36,Deep River,2012,2096,26,5,23,0,54,2.58
37,Derby,2012,5849,259,307,63,0,629,10.75
38,Durham,2012,2694,33,1,13,0,47,1.74
40,East Granby,2012,2152,72,4,32,0,108,5.02
41,East Haddam,2012,4508,73,0,30,1,104,2.31
42,East Hampton,2012,5485,70,5,76,25,176,3.21
43,East Hartford,2012,21328,1577,1024,908,0,3509,16.45
44,East Haven,2012,12533,421,128,294,0,843,6.73
45,East Lyme,2012,8458,342,8,80,19,449,5.31
47,East Windsor,2012,5045,558,49,100,14,721,14.29
39,Eastford,2012,793,0,0,19,0,19,2.4
46,Easton,2012,2715,0,0,0,11,11,0.41
48,Ellington,2012,6665,260,8,83,0,351,5.27
49,Enfield,2012,17558,1340,215,546,7,2108,12.01
50,Essex,2012,3261,36,6,9,0,51,1.56
51,Fairfield,2012,21648,241,181,29,116,567,2.62
52,Farmington,2012,11106,456,110,117,155,838,7.55
53,Franklin,2012,771,0,1,16,0,17,2.2
54,Glastonbury,2012,13656,582,47,122,2,753,5.51
55,Goshen,2012,1664,1,0,5,0,6,0.36
56,Granby,2012,4360,85,2,42,5,134,3.07
57,Greenwich,2012,25631,837,421,2,54,1314,5.13
58,Griswold,2012,5118,136,41,159,0,336,6.57
59,Groton,2012,17978,3267,52,337,10,3666,20.39
60,Guilford,2012,9596,168,6,29,0,203,2.12
61,Haddam,2012,3504,22,1,15,0,38,1.08
62,Hamden,2012,25114,684,523,448,4,1659,6.61
63,Hampton,2012,793,0,0,18,0,18,2.27
64,Hartford,2012,51822,9415,8390,1440,0,19245,37.14
65,Hartland,2012,856,2,0,6,0,8,0.93
66,Harwinton,2012,2282,23,0,25,0,48,2.1
67,Hebron,2012,3567,59,3,36,0,98,2.75
68,Kent,2012,1665,48,0,4,0,52,3.12
69,Killingly,2012,7592,530,120,309,0,959,12.63
70,Killingworth,2012,2598,0,2,5,5,12,0.46
71,Lebanon,2012,3125,26,4,56,0,86,2.75
72,Ledyard,2012,5987,32,6,168,0,206,3.44
73,Lisbon,2012,1730,2,0,43,0,45,2.6
74,Litchfield,2012,3975,140,1,12,29,182,4.58
76,Madison,2012,8049,90,1,8,29,128,1.59
77,Manchester,2012,25996,1813,1074,884,36,3807,14.64
78,Mansfield,2012,6017,417,153,86,2,658,10.94
79,Marlborough,2012,2389,24,0,20,0,44,1.84
80,Meriden,2012,25892,1769,1008,1022,11,3810,14.71
81,Middlebury,2012,2892,76,4,12,8,100,3.46
82,Middlefield,2012,1863,30,1,10,1,42,2.25
83,Middletown,2012,21223,2814,987,590,25,4416,20.81
84,Milford,2012,23074,822,277,212,85,1396,6.05
85,Monroe,2012,6918,35,1,19,1,56,0.81
86,Montville,2012,7407,81,30,201,0,312,4.21
87,Morris,2012,1314,20,2,0,0,22,1.67
88,Naugatuck,2012,13061,492,293,301,0,1086,8.31
89,New Britain,2012,31226,3183,1627,1153,382,6345,20.32
90,New Canaan,2012,7551,140,10,2,31,183,2.42
91,New Fairfield,2012,5593,0,0,25,13,38,0.68
92,New Hartford,2012,2923,12,1,38,15,66,2.26
93,New Haven,2012,54967,8210,6138,1127,545,16020,29.14
95,New London,2012,11840,1672,144,457,83,2356,19.9
96,New Milford,2012,11731,233,259,123,16,631,5.38
94,Newington,2012,13011,426,105,366,36,933,7.17
97,Newtown,2012,10061,134,2,23,15,174,1.73
98,Norfolk,2012,967,28,0,3,0,31,3.21
99,North Branford,2012,5629,62,7,55,0,124,2.2
100,North Canaan,2012,1587,101,0,7,0,108,6.81
101,North Haven,2012,9491,343,28,74,1,446,4.7
102,North Stonington,2012,2306,0,1,21,0,22,0.95
103,Norwalk,2012,35415,2248,947,238,616,4049,11.43
104,Norwich,2012,18659,1906,728,518,0,3152,16.89
105,Old Lyme,2012,5021,60,1,7,3,71,1.41
106,Old Saybrook,2012,5602,50,5,16,1,72,1.29
107,Orange,2012,5345,46,4,9,0,59,1.1
108,Oxford,2012,4746,36,1,8,0,45,0.95
109,Plainfield,2012,6229,378,224,296,0,898,14.42
110,Plainville,2012,8063,223,25,302,21,571,7.08
111,Plymouth,2012,5109,179,5,152,0,336,6.58
112,Pomfret,2012,1684,32,2,17,0,51,3.03
113,Portland,2012,4077,185,92,51,0,328,8.05
114,Preston,2012,2019,40,4,36,0,80,3.96
115,Prospect,2012,3474,0,4,25,0,29,0.83
116,Putnam,2012,4299,383,73,133,0,589,13.7
117,Redding,2012,3811,0,0,0,0,0,0
118,Ridgefield,2012,9420,179,0,8,33,220,2.34
119,Rocky Hill,2012,8843,236,29,173,0,438,4.95
120,Roxbury,2012,1167,19,0,1,0,20,1.71
121,Salem,2012,1635,1,0,28,0,29,1.77
122,Salisbury,2012,2593,16,1,5,10,32,1.23
123,Scotland,2012,680,0,0,11,0,11,1.62
124,Seymour,2012,6968,262,16,89,0,367,5.27
125,Sharon,2012,1775,20,0,4,0,24,1.35
126,Shelton,2012,16146,254,21,83,82,440,2.73
127,Sherman,2012,1831,0,1,1,0,2,0.11
128,Simsbury,2012,9123,241,11,58,0,310,3.4
129,Somers,2012,3479,54,7,18,0,79,2.27
132,South Windsor,2012,10243,427,54,235,0,716,6.99
130,Southbury,2012,9091,89,2,14,0,105,1.15
131,Southington,2012,17447,609,42,281,51,983,5.63
133,Sprague,2012,1248,20,9,31,0,60,4.81
134,Stafford,2012,5124,178,11,160,0,349,6.81
135,Stamford,2012,50573,4618,1605,309,1295,7827,15.48
136,Sterling,2012,1511,0,1,35,0,36,2.38
137,Stonington,2012,9467,296,17,52,0,365,3.86
138,Stratford,2012,21091,524,375,259,33,1191,5.65
139,Suffield,2012,5469,212,0,52,15,279,5.1
140,Thomaston,2012,3276,105,4,91,0,200,6.11
141,Thompson,2012,4171,150,13,83,0,246,5.9
142,Tolland,2012,5451,97,1,79,3,180,3.3
143,Torrington,2012,16761,1082,297,611,17,2007,11.97
144,Trumbull,2012,13157,315,12,35,314,676,5.14
145,Union,2012,388,0,0,9,0,9,2.32
146,Vernon,2012,13896,1386,533,352,12,2283,16.43
147,Voluntown,2012,1127,20,2,23,0,45,3.99
148,Wallingford,2012,18945,482,140,298,35,955,5.04
149,Warren,2012,811,0,0,4,0,4,0.49
150,Washington,2012,2124,14,0,0,23,37,1.74
151,Waterbury,2012,47991,4870,3149,2256,326,10601,22.09
152,Waterford,2012,8634,123,17,208,0,348,4.03
153,Watertown,2012,9096,206,24,134,0,364,4
155,West Hartford,2012,26396,541,943,304,287,2075,7.86
156,West Haven,2012,22446,1024,1503,415,0,2942,13.11
154,Westbrook,2012,3937,140,8,13,24,185,4.7
157,Weston,2012,3674,0,1,0,0,1,0.03
158,Westport,2012,10399,245,20,2,15,282,2.71
159,Wethersfield,2012,11677,625,127,216,0,968,8.29
160,Willington,2012,2637,160,2,37,0,199,7.55
161,Wilton,2012,6475,84,5,7,140,236,3.64
162,Winchester,2012,5613,316,269,122,0,707,12.6
163,Windham,2012,9570,1692,436,448,0,2576,26.92
164,Windsor,2012,11767,154,282,379,26,841,7.15
165,Windsor Locks,2012,5429,137,178,182,0,497,9.15
166,Wolcott,2012,6276,312,3,121,0,436,6.95
167,Woodbridge,2012,3478,30,3,6,0,39,1.12
168,Woodbury,2012,4564,60,4,19,0,83,1.82
169,Woodstock,2012,3582,24,3,52,0,79,2.21
1,Ansonia,2011,8148,372,699,106,9,1186,14.56
2,Bloomfield,2011,9019,584,147,295,0,1026,11.38
3,Bridgeport,2011,57012,5604,3724,964,15,10307,18.08
4,Bristol,2011,27011,1771,791,1014,0,3576,13.24
5,Danbury,2011,31154,1586,952,315,273,3126,10.03
6,Derby,2011,5849,259,305,63,0,627,10.72
7,East Hartford,2011,21328,1577,835,908,0,3320,15.57
8,East Windsor,2011,5045,558,27,92,14,691,13.7
9,Enfield,2011,17558,1340,215,546,7,2108,12.01
10,Groton,2011,17978,3267,56,337,10,3670,20.41
11,Hartford,2011,51822,9415,7577,1440,0,18432,35.57
12,Killingly,2011,7592,530,124,251,0,905,11.92
13,Manchester,2011,25996,1813,1011,883,36,3743,14.4
14,Mansfield,2011,6017,417,159,76,2,654,10.87
15,Meriden,2011,25892,1769,970,1022,11,3772,14.57
16,Middletown,2011,21223,2814,1295,590,25,4724,22.26
17,New Britain,2011,31226,3183,1457,1153,396,6189,19.82
18,New Haven,2011,54967,8210,6116,1127,487,15940,29
19,New London,2011,11840,1672,155,457,69,2353,19.87
20,Norwalk,2011,35415,2248,982,238,559,4027,11.37
21,Norwich,2011,18659,1906,707,517,0,3130,16.77
22,Plainfield,2011,6229,378,225,261,0,864,13.87
23,Putnam,2011,4299,383,64,101,0,548,12.75
24,Stamford,2011,50573,4618,1645,309,1221,7793,15.41
25,Torrington,2011,16761,1082,301,611,17,2011,12
26,Vernon,2011,13896,1386,519,352,12,2269,16.33
27,Waterbury,2011,47991,4870,3110,2256,333,10569,22.02
28,West Haven,2011,22446,1024,1380,415,0,2819,12.56
29,Winchester,2011,5613,316,248,116,0,680,12.11
30,Windham,2011,9570,1692,560,427,0,2679,27.99
31,Andover,2011,1317,24,1,20,0,45,3.42
32,Ashford,2011,1903,32,1,35,0,68,3.57
33,Avon,2011,7389,240,5,21,0,266,3.6
34,Barkhamsted,2011,1589,0,3,11,0,14,0.88
35,Beacon Falls,2011,2509,0,6,25,0,31,1.24
36,Berlin,2011,8140,468,30,82,6,586,7.2
37,Bethany,2011,2044,0,0,1,0,1,0.05
38,Bethel,2011,7310,250,9,57,63,379,5.18
39,Bethlehem,2011,1575,24,0,0,0,24,1.52
40,Bolton,2011,2015,0,3,15,0,18,0.89
41,Bozrah,2011,1059,0,4,16,0,20,1.89
42,Branford,2011,13972,232,46,174,0,452,3.24
43,Bridgewater,2011,881,0,0,2,0,2,0.23
44,Brookfield,2011,6562,35,6,38,52,131,2
45,Brooklyn,2011,3235,233,9,63,0,305,9.43
93,Lyme,2011,1223,0,0,2,7,9,0.74
46,Burlington,2011,3389,28,0,25,0,53,1.56
47,Canaan,2011,779,25,0,9,1,35,4.49
48,Canterbury,2011,2043,76,1,31,0,108,5.29
49,Canton,2011,4339,211,20,52,32,315,7.26
50,Chaplin,2011,988,0,1,23,0,24,2.43
51,Cheshire,2011,10424,237,5,70,17,329,3.16
52,Chester,2011,1923,23,2,9,0,34,1.77
53,Clinton,2011,6065,84,5,42,0,131,2.16
54,Colchester,2011,6182,364,26,84,0,474,7.67
55,Colebrook,2011,722,0,0,7,1,8,1.11
56,Columbia,2011,2308,24,4,37,0,65,2.82
57,Cornwall,2011,1007,18,0,0,0,18,1.79
58,Coventry,2011,5099,104,5,116,20,245,4.8
59,Cromwell,2011,6001,212,6,199,0,417,6.95
60,Darien,2011,7074,83,8,1,93,185,2.62
61,Deep River,2011,2096,26,4,22,0,52,2.48
62,Durham,2011,2694,33,1,11,0,45,1.67
63,East Granby,2011,2152,72,1,30,0,103,4.79
64,East Haddam,2011,4508,73,3,27,1,104,2.31
65,East Hampton,2011,5485,70,1,69,25,165,3.01
66,East Haven,2011,12533,421,254,294,0,969,7.73
67,East Lyme,2011,8458,342,61,78,10,491,5.81
68,Eastford,2011,793,0,0,16,0,16,2.02
69,Easton,2011,2715,0,33,0,11,44,1.62
70,Ellington,2011,6665,260,6,69,0,335,5.03
71,Essex,2011,3261,36,4,8,0,48,1.47
72,Fairfield,2011,21648,241,182,29,117,569,2.63
73,Farmington,2011,11106,456,110,117,154,837,7.54
74,Franklin,2011,771,0,1,15,0,16,2.08
75,Glastonbury,2011,13656,582,49,122,0,753,5.51
76,Goshen,2011,1664,1,1,5,0,7,0.42
77,Granby,2011,4360,85,1,34,5,125,2.87
78,Greenwich,2011,25631,837,359,2,54,1252,4.88
79,Griswold,2011,5118,136,42,140,0,318,6.21
80,Guilford,2011,9596,168,5,28,0,201,2.09
81,Haddam,2011,3504,22,1,14,0,37,1.06
82,Hamden,2011,25114,684,514,448,4,1650,6.57
83,Hampton,2011,793,0,0,16,0,16,2.02
84,Hartland,2011,856,2,0,4,0,6,0.7
85,Harwinton,2011,2282,23,1,21,0,45,1.97
86,Hebron,2011,3567,59,3,30,0,92,2.58
87,Kent,2011,1665,48,1,4,24,77,4.62
88,Killingworth,2011,2598,0,1,5,5,11,0.42
89,Lebanon,2011,3125,26,5,47,0,78,2.5
90,Ledyard,2011,5987,32,7,158,0,197,3.29
91,Lisbon,2011,1730,2,0,35,0,37,2.14
92,Litchfield,2011,3975,140,2,11,29,182,4.58
94,Madison,2011,8049,90,1,7,29,127,1.58
95,Marlborough,2011,2389,24,0,16,0,40,1.67
96,Middlebury,2011,2892,76,3,8,8,95,3.28
97,Middlefield,2011,1863,30,0,10,1,41,2.2
98,Milford,2011,23074,822,285,212,85,1404,6.08
99,Monroe,2011,6918,35,1,18,1,55,0.8
100,Montville,2011,7407,81,30,177,0,288,3.89
101,Morris,2011,1314,20,2,0,0,22,1.67
102,Naugatuck,2011,13061,492,273,301,0,1066,8.16
103,New Canaan,2011,7551,140,10,2,31,183,2.42
104,New Fairfield,2011,5593,0,0,22,13,35,0.63
105,New Hartford,2011,2923,12,0,36,15,63,2.16
106,New Milford,2011,11731,233,221,107,16,577,4.92
107,Newington,2011,13011,426,84,366,36,912,7.01
108,Newtown,2011,10061,134,4,20,15,173,1.72
109,Norfolk,2011,967,28,0,3,0,31,3.21
110,North Branford,2011,5629,62,8,52,0,122,2.17
111,North Canaan,2011,1587,101,0,7,0,108,6.81
112,North Haven,2011,9491,343,29,74,1,447,4.71
113,North Stonington,2011,2306,0,1,17,0,18,0.78
114,Old Lyme,2011,5021,60,1,5,3,69,1.37
115,Old Saybrook,2011,5602,50,5,15,1,71,1.27
116,Orange,2011,5345,46,4,9,0,59,1.1
117,Oxford,2011,4746,36,1,8,0,45,0.95
118,Plainville,2011,8063,223,24,302,53,602,7.47
119,Plymouth,2011,5109,179,5,142,0,326,6.38
120,Pomfret,2011,1684,32,2,11,0,45,2.67
121,Portland,2011,4077,185,91,48,0,324,7.95
122,Preston,2011,2019,40,3,34,0,77,3.81
123,Prospect,2011,3474,0,4,22,0,26,0.75
124,Redding,2011,3811,0,0,0,0,0,0
125,Ridgefield,2011,9420,179,0,8,20,207,2.2
126,Rocky Hill,2011,8843,236,23,173,0,432,4.89
127,Roxbury,2011,1167,19,0,1,0,20,1.71
128,Salem,2011,1635,1,0,25,0,26,1.59
129,Salisbury,2011,2593,16,0,4,10,30,1.16
130,Scotland,2011,680,0,0,9,0,9,1.32
131,Seymour,2011,6968,262,25,83,0,370,5.31
132,Sharon,2011,1775,20,1,4,0,25,1.41
133,Shelton,2011,16146,254,16,83,82,435,2.69
134,Sherman,2011,1831,0,1,1,0,2,0.11
135,Simsbury,2011,9123,241,12,58,0,311,3.41
136,Somers,2011,3479,54,7,16,0,77,2.21
137,South Windsor,2011,10243,427,53,235,0,715,6.98
138,Southbury,2011,9091,89,2,12,0,103,1.13
139,Southington,2011,17447,609,41,281,51,982,5.63
140,Sprague,2011,1248,20,9,30,0,59,4.73
141,Stafford,2011,5124,178,12,140,0,330,6.44
142,Sterling,2011,1511,0,3,21,9,33,2.18
143,Stonington,2011,9467,296,16,49,0,361,3.81
144,Stratford,2011,21091,524,365,259,33,1181,5.6
145,Suffield,2011,5469,212,0,41,15,268,4.9
146,Thomaston,2011,3276,105,3,83,0,191,5.83
147,Thompson,2011,4171,150,12,54,0,216,5.18
148,Tolland,2011,5451,97,2,69,3,171,3.14
149,Trumbull,2011,13157,315,13,35,274,637,4.84
150,Union,2011,388,0,0,6,0,6,1.55
151,Voluntown,2011,1127,20,2,21,0,43,3.82
152,Wallingford,2011,18945,482,141,299,35,957,5.05
153,Warren,2011,811,0,0,2,0,2,0.25
154,Washington,2011,2124,14,0,0,23,37,1.74
155,Waterford,2011,8634,123,13,192,0,328,3.8
156,Watertown,2011,9096,206,19,134,0,359,3.95
157,West Hartford,2011,26396,541,942,304,282,2069,7.84
158,Westbrook,2011,3937,140,7,13,24,184,4.67
159,Weston,2011,3674,0,1,0,0,1,0.03
160,Westport,2011,10399,245,20,2,15,282,2.71
161,Wethersfield,2011,11677,625,127,216,0,968,8.29
162,Willington,2011,2637,160,4,32,0,196,7.43
163,Wilton,2011,6475,84,4,7,70,165,2.55
164,Windsor,2011,11767,154,245,379,0,778,6.61
165,Windsor Locks,2011,5429,137,149,182,0,468,8.62
166,Wolcott,2011,6276,312,4,121,0,437,6.96
167,Woodbridge,2011,3478,30,5,6,0,41,1.18
168,Woodbury,2011,4564,60,4,19,0,83,1.82
169,Woodstock,2011,3582,24,3,39,0,66,1.84
